PSPPPPPMPP
PMPPPPPPPP
PPPPPPPPPP
PPPPPMPPPP
PPPPPPPPPP
PPMMPPPPMP
PPMPPPPPPP
PPPPPPMPPP
PPPPPPPPMP
PPMPPPMSPP
