PPPPPMSMPP
PPMPMPPPPP
PPPPPMPPPP
PPPPPPPPPP
PMPPPPMPPP
PPPPPPPPPP
PMPMMPPPPP
PPPSMMPPMP
PPPPPPPPPP
PPPPMMPPPM
