SPPPPPPPMP
MMPPPPPMPP
PPPPPMPPPM
PPPPPPPPPP
PPPMPPPPPP
MPPPPMPPPP
PMMPPPMPMP
PPPPPPPSPP
MPPPPMPPPP
PPPPPPPPMM
